R 900 700
NO ./textures/redbrick.xpm
SO ./textures/wood.xpm
WE ./textures/colorstone.xpm
EA ./textures/bluestone.xpm

S ./textures/barrel.xpm
F 100, 0, 0  
C 0,0,100
        1111111111111111111111111111111111111111111111111111111111
        1000000000110000000000000000000000000000000000000000000001
        1011002001110020000000000000000000000000000000000000000001
        100120000000000000N000000000000000000000000000000000000001
111111111011000001110020000000000000000000000000000000000000000001
10000000001100000111000000000111111111111111111111111111111111111
11110111111111011100011111111
11110111111111011101010000001
11000000110101011100000000001
10000000000000001100000000001
10000000000000001101010000001
110000011101010111110111100111
11110111 1110101 101111010001
11111111 1111111 111111111111

