R 900 500
SO ./textures/bookshelf.xpm
NO ./textures/bark.xpm
WE ./textures/colorstone.xpm
EA ./textures/bluestone.xpm

S ./textures/pillar.xpm
F 100,0,5
C 0,0,90
        
        111111111111111111111111111111111111111111111111111111111111111111111
        100000000011000200000000000000000000000000000000000000000000000000001
        101100200111000000000000000000000000000000000000000000000000000000001
        10012000000000200W00000000000000000000000000000000000000000000000001
11111111101100000111000000000000000000000000000000000000000000000000000000001
10000000001100000111000200000111111111111111111111111111111111111111111111111
11110111111111011100011111111
11110111111111011101010000001
11000000110101011100000000001
10002000000000001100000000001
10000000000000001101010000001
110000011101010111110111100111
11110111 1110101 101111010001
11111111 1111111 111111111111
