R 900 500
SO ./textures/lion64.xpm
NO ./textures/situle64.xpm
WE ./textures/griffon64.xpm
EA ./textures/archer64.xpm

S ./textures/pillar.xpm
F 100,0,5
C 0,0,90
        
        1111111111111111111111111
        1000000000110002000000001
        1011002001110000000000001
        100120000000E002000000001
111111111011000001110000000000001
100000000011000001110002000001111
11110111111111011100011111111
11110111111111011101010000001
11000000110101011100000000001
10002000000000001100000000001
10000000000000001101010000001
110000011101010111110111100111
11110111 1110101 101111010001
11111111 1111111 111111111111
